"","dept","applicant.gender","admit","reject","applications","dept_id","male"
"1","A","male",512,313,825,1,1
"2","A","female",89,19,108,1,0
"3","B","male",353,207,560,2,1
"4","B","female",17,8,25,2,0
"5","C","male",120,205,325,3,1
"6","C","female",202,391,593,3,0
"7","D","male",138,279,417,4,1
"8","D","female",131,244,375,4,0
"9","E","male",53,138,191,5,1
"10","E","female",94,299,393,5,0
"11","F","male",22,351,373,6,1
"12","F","female",24,317,341,6,0
